...#.#.........#.....#..#.....#..........#.............#.##..........................##....#...#....
..............#......#.............................................#.....#..........................
.#..........#.....#......#........#.........#...#.............................#...........#.........
................#....#.#.##.#........#.....................................#.......#.........#....#.
....................................#.......#....#................................#....#............
....#.............#..#.#.....#........#......#.........#..#.........................#...............
.................#.............##...#.##.......#.......#.....#.............#..#.#......##...#.......
#.##.............#....#................###...#.#................#.........#.....#.................#.
.....#..................#.....#...........#...................#...#..#........................#.....
.#...............#.#......#...#.............#..#.#.............................#................#...
..#.#..#........#........#...................-#.....-...............#....#..#...#............#......
.........#....##......#...#.....#.....................#.....#.#.......#..............#..#......#....
...#......#.#..#................................#...#..#....#.......#...............................
......#......#..................#..................-..............##.#.....#..#.....#...............
#.......##...............#...#.#.#.#.........-#.-#...-....#.#..#......................#......#......
.......................#.........#............#-.-........#....................#......#....##.#.....
....#.......................#................#.....................................#................
.......#...#.........#.#.#........#....#............#.....#....#....................#..##...........
.......#...............#..#.......#.##.#....#............#..............#...#.##..............#.....
................#.................#.................#.............#....#.#.....#....................
..............#...............#....................#......#...#.........#..............#...#.....#..
...#...................#.....................##...#...................#....#.......#..#.............
.........#......#......#.......................................................##......#.....#.....#
#....#.#................#.......#............#....#........#.#..............#.......................
..#.....#....................#.................#....#..#..........................#..#..............
.......#.............................#.....#...........#.#...........##....#................#....#..
........#.........#.#............#..##...............#..............................................
......#.##......#.....#.......#....#.............##...#......#.......#..............#......#.......#
#..........#.#.#......##....#...#.................#............#............#...................#...
................#..#................##...............#..........#........#.....................#....
.............#..#...#..............#...............##...........#.......#...#......#................
................#................#...............#....#........#...##........#...#........#.##......
.............#........###..............#..#...........#..#.............#.#...................#..#...
........#........#...............#..........#..........................#.........#..#...............
#.......#........#....#........................##..........#.....#..............#....#..............
.#..#............#............................#.#....#.......#.......................#.#...#.#...##.
.......#......................#.........#.................#.#.............#.#....#..............#...
..#................#........#............#...................#..................##..............#...
.........#.......#..............##...........#.................#......#...............#..........#..
....##.#..#.........................#.#.......#.............#.........#..#.................#......#.
#...#.........##....#...................##.......................................#..................
.......#...##....................#.................#.##.....#...#...#.#.........#...................
.........#.....#........#........#........................#.........................................
...#................#..#...#...#............#....#.................#........#................#......
........#..#.......................................#.......#...#.....##.#..............#.....#......
#..............#............#.....##...........#........#............#.....#....#........#....#.....
..#................#...#...#.#...#..##..................................##......#...#..........#....
#....#...........#.#......#..............#........#.#.....#....#....#...................#...........
.............#..#.....#..#..#....................#........#.....#..............#....#........#......
....#.#..............#.#................#.....#.....#...........#.#.#..........#............#..#....
............#......................#.......#.....#@.............#..........#.............#....#.....
.........................................................................#.............##.#.#.....#.
.................#..#...#.......#.#.............#...#.#.....#......#.........#......#.........#.....
......#.......#.......#........#.....................#............#........#............#...........
......##.....#............#...........#...#.........#..............#.......#....#...................
.........................##...#....................#............#.........##....#...................
....#..#....#....#..#..#......#......##......##....#.........................##.........#...........
....#.....#.#...#.........#.#...................................#.....................#.......#.....
..#.....................#......#................#..##....#.#................#...................#...
.....................#....#..............#.......#......#..#............................#.....#..#.#
....#..#.....#......#...#........#..#............#......#..............#...............#.....#.....#
#.................#..........##.............#.....#................#.#..###........#....#...........
........#...##....#....#......#...#.....#.#....#........#.#..###........#..................#........
..........................#....##....#.............#................................................
#...........................................#..#.............#..............#.....................##
...#.......#...........#.#............#..........##.........#..........#..#....#....................
....#...........................#...........#................................................#......
........................#.....#.............#....................................#.............#....
.....#.......##...#...........#........#...#...#...#.#.........................#......#.#..#........
......##....................##.....................#.#.................#.#.#..........#.....#.......
.#.#...........#......................#.#...##..#......#..........##..........#..........#.#.......#
.....#...#.##......#.........#...................##.....................#.......#...................
.....................#.#...................#......................#.#.....#........##......#..#....#
...............#............#............................................#........#....#......#.....
........#.......#................#..#............#..#........#.......#...........................#..
....#.............#.....##..#.................#.#..............#...#.......#......#...#.....#...#.#.
...#.......#.....................#.............#..........#...#..................................#..
.............#..#.......#.............#..................#..#.............#..#........#..#...#......
..........#..##....#....................#.........................##.......#................#...#...
..........#....#.#........#.............#...............#......#.......#..................#.....#...
.......#.....................#...................#...............#...#...............#........#.....
.............###...##..............#........................................#................#......
..................#...#............#................##.......................##.................#...
.....#...............#............................#.#.........#...#.#..........#.........#.##.......
.#.......#.........#.......#......#...........+..........#.................#..#..#..........#......#
....#........#............##....#..................#+#....#.........................................
........#..#......##.....#...#...............+....##....#.#....##.#....##...........................
...................#...........#.#......#........#......#..........#...................#.....#......
..#........#.#..........#..............#.#..#....#.....#............#....#.....#..................#.
.#..........#.......##..#..#......#.##....................#.......#.....#......................#....
.#..#........#..................##.....................#.............#.##......#....#...#......#..#.
........##....................#.##.........#......................#.......#.#...#......#............
.......#..#.............#...................##....#.................#................##.....##......
...................#.......#....##..#.....#.....#....##...#.#...................#........#.#.......#
#...........#........#.........#.#.....#......................#.#..............#...........#..#.....
#............#........#...#.......#.......##.....#.#......#.............#.....#................#....
#............#.#.............#.................##...........#...................#.##........#.#.....
.......................##............................................#.#......#....#....#...##..#...
.....#............................#..#........#........#..........#.............#...........#.......
...#...#....................#...#......#...##.....................#...#..##....#......#.....##....#.
