........................................#......##.....#...#........#............#.#.....#....#..#...
.......................#...........................##.#..............#........#.................#...
..#.#.......#.............#..........#.....#............#..................#.#...............##.....
........#..#.#...................#...#.........#.....#.......#......#............#......#........#.#
................#.......#......#.#......................#.....#.#.#.....#..........#....#........#..
#....#...................#......#.......#.....#.#................#..........#.......................
......#....................#...............................#..#..............#...#..#...............
.#.....................#................#.....#......#......##.......#...##..................#......
#..............#.....##......###........###........................................#.#...#.....#....
........#.........##.........#.................#..............#............#...........#.#.......#..
....##.....#..#...............#....#..................#.#.....#....................................#
..................................#.........#........#............#......#............#........#....
..........................#......................-......................##.....#..##................
....#......#.........#.....#...#........#..........-......#......#....#.......#........##....#......
.............#...............................-..........#....#..........####................#.#.....
........#.........................#............#.....#......#.......................................
...........#......#.#.#..................#...#........#..#.......#.........##.......................
.........#.#.............##..........#.....#..#..#....#.............#.........##....................
#......#............##.#..#...........#......-..-.........##..........................#.#.#.###.....
...........#.#..............#...................-..-.-.......#..#..#.........#.............#...#....
..#...........#.#........#...#...#....#.........#...............#..#........................#.......
.............#....#...........#........#.......#................................#...#...............
........#................#...............................#..........#.........#..#.#...##...........
.............#.....#...#......#...#............#...#.......#..#..............................#......
.#...#....#.......#........#..#.......#.......##......#...#....#....##..#.........#...##.......#....
.....#....#.......#...#......#.............#......................#...##.....#.......#.#......#..#..
....#............#.....#...#............#.......#......#....................................#.......
.......................................#.........#.#..................##.....#...............#..#...
..##.................................#...#......#......#.............................#.......#......
..#..............#...........#...........................#........#........#......#.................
#...#........#..........#.......###.....#................#..............#....#.#...............#...#
.#.#.#.#.#.....#.........#........#............#............................#....#..................
....##.#.....#...#.............#..#...#.....#......#..........#....#.#................#............#
.......................#.......#.............#...................#.##..#.#...............#.....#....
.#..............#...#.........#.#.......#..........#.............#...#.##.................#....#....
.#........#.#.........##..#...##........#........#.#....####..............##.............#..........
....................#.......#...#...................................#..........#..........#.........
...#...........................#........#.................................#........#....#.....#.....
.........#..........#..#................#..........#...............#..............#.......#.........
........................................................#.##.....................#.#...#..........##
...#......#............#......#...........#.........#.........#.........#....................#......
#.....................#.........#......#.....#..#.........#.#...#........#..........................
#........#.....#.......#...........##...............#...........#..........#.......#...#.#..........
...........#......#.............#..................#................#.................#............#
.........#......#................................#.....#....#....#....#.............................
.##..#.....................#..................................#.#.#..............#.............#....
##................##..#.....#..#.#...................#.......................#.......#.##.......#...
..#.......#........#............#.................#..............#....................#......#......
..#........#........................#......#..#.#....##........#.#...#.....#.#......#..............#
#.#.....#.........................#.........#...........##..............#..........................#
.#.#.................................#...#........@......................#............#.........#...
...#...............#...............#........#.....................#.............#............#......
.#..................................##...#....................#..................##.........#....#..
......#...........#.......#.....#.#...#..#.............#........#..........##..........#..#.........
.......................#.#....................#.......#...................#........#...............#
....#..................................#.........................#........................#.......#.
......#......#.....................................#............#.......................#..##.......
..##.#..............#..............#.........##.....#............#..........#.#.....................
.........................#..........#............#...........#...........#...........#..##..#..#....
.....#..#...........#.........#......#.#.............................................#...........#..
....................#............#.##...#.......#.....#...#....#.#...............#.....#......#..#.#
#.................#................................#......#.....#..............#...##...............
....................#.#.....#...##...#......#....#....#.............#.............#..............#..
..........#........#.............#...............#.#...#.........#...........#.....#.............#..
#.................#...#.#.....#...........................#............#........#...................
..............#..#.#.......#..#.............................................#........#.......##.#...
......#............##.#........................#....................#...........#...................
..#........#.........................#..#......#.............................#..#.....#.#...........
........#.......#.........#...........#..........#..#..........................#........#..........#
.#.....###........#......................#..........#.##....#.#...##...........................#...#
..#....................#................#.................#......#.....#....##..................#...
...#..#..........#..#..#.....................#.....................#................#......#........
.#..................#......#..#.....#.......##........#.............#..........#...#..#.............
.............#.......#........#...##....#.....#......................#......#..##........#..........
...#.#.....#.......#...........#.#.....#........#..........#..........#.............#........#......
................#.......................#...........#....#......#....#.#.......#..............#..#.#
..............#.#...........................#....#.#...#..#.#....#.......#.....#....................
.....................#...............#......#.......##...................................#....#.....
...#....#..............................................##........#.......#.#.............#..........
..............#.##.............#......#.............#.......##............#...............##........
......#.#...##...................................#...............................#......#...........
.....#.......#..................#..............#..........#.......#...#...........#.......#.........
.........#............#........#....................#..#....................#........##....#........
.#.#.......#................................#..................#........#................#...#...##.
..................#.#.....#........#...#........#......#...#...........#............................
........#.#............#.............#..#.............#....#...................................#....
.........#...................#.................#.........#.#..#...............#.......#.............
.#....#..........##.......#....#..........#..........+...#..........#...#...#......#..##......#.....
...#.....................................#..#.#.....#...##..#...##....#............#.#............#.
................................#........#......#.#.........#....#...#.................#........#...
#....................#..........................................#...................................
..................#......##.....#...............#.....#...#.....#.#........#........##.....##.......
..#.............#........#.....#...........#...#.#....................#....#...................#....
.....#..........#.........#........#....#.....##..........#.....#.........#......#.........##..#....
..................#..........#.#.#.....................#............##..#...........#..#............
................##...........#............#.............................#....#....#...#..##....#....
.......................................#..................#..#..#..#......#.....................#...
...............#..#.............#........#.......#...................#......#.............#.........
...................##.....#.##................#.................................................#...
..............#...........#......#..............#...##.....#.....#............#.....................
